STAGE,,,,,,,,,,
1,1,1,1,1,1,1,1,1,1, 
1,1,1,1,1,1,1,1,1,1, 
1,1,1,1,1,1,1,1,1,1, 
1,1,1,1,1,1,1,1,1,1, 
1,0,1,1,1,1,1,1,1,1, 
1,1,1,1,1,1,1,1,1,1, 
1,1,1,1,1,1,1,1,1,1, 
1,1,1,1,1,1,1,1,1,1, 
1,1,1,1,1,1,1,1,1,1, 
1,1,1,1,1,1,1,1,1,1, 
OBJECT,,,,,,,,,,
0,0,0,0,0,0,0,0,0,0, 
0,0,0,0,0,0,0,0,0,0, 
0,0,0,0,0,0,0,0,0,0, 
0,0,0,0,0,0,0,0,0,0, 
0,0,0,0,0,0,0,0,0,0, 
0,0,0,0,0,0,0,0,0,0, 
0,0,0,0,0,0,0,0,0,0, 
0,0,0,0,0,0,0,0,0,0, 
0,0,0,0,0,0,0,0,0,0, 
0,0,0,0,0,0,0,0,0,0, 
